111111111111111111111111
10000000000000000000C001
100000000000000000000001
10E0000C0000000000000001
100000000000000000000001
10000000000000000000C001
100000000000000000000001
10000000000000000P000001
111111111111111111111111
