111111111
10000CC01
1E0000001
1000E0001
111111111 

