11111111
10000001
1E0P00C1
11111111
