111111111111111111
1CE000000000000001
11000000000000P011
100000000000000001
100000000000000001
100000000000000001
10000000000000C001
100C00000000000001
111111111111111111