11111111111111111111
1P000000000000000001
1C000000000000000E01
1C000000000000000001
10111C00000000000001
1C000000000000000C01
11111111111111111111
