11111111111111111111
1P000000000000000001
1C000000000000000E01
1C000000000000000001
10111C00000000000111
1C000000000000000001
11111111111111111111
