111111111111111111
10E000000000000001
10C000000000000P01
100000000000000001
100000000000000001
100000000000000001
10000000000000C001
100C00000000000001
111111111111111111